111111111
1P0C001E1
1110C0C01
1C0CC0101
111111111
111111111