1111111
1P00CE1
1C0C001
1GGG0C1
1111111