1111111111111111111
1P00C000000000001E1
1C0C001010001100001
1110001111000011011
1GGG0000000000000C1
1C0C000010001100001
1C0C000010001100001
1C0C000010000110001
1C0C000010001100001
1C0C001010001100001
1111111111111111111